1	1	1	1	1	1	1	1	1	1	1	1	1	1	1	1	1	1	1	1	1
2	2	2	2	2	2	2	2	2	2	2	2	2	2	2	2	2	2	2	2	2
3	3	3	3	3	3	3	3	3	3	3	3	3	3	3	3	3	3	3	3	3
4	4	4	4	4	4	4	4	4	4	4	4	4	4	4	4	4	4	4	4	4
5	5	5	5	5	5	5	5	5	5	5	5	5	5	5	5	5	5	5	5	5
6	6	6	6	6	6	5	6	5	6	6	6	6	6	6	6	6	6	6	6	6
7	7	7	7	7	7	5	7	5	7	7	7	7	7	7	7	7	7	7	7	7
8	8	8	8	8	8	5	8	5	8	8	7	7	8	8	8	8	8	8	8	7
9	9	9	9	9	9	5	9	5	9	9	7	8	9	9	9	9	9	9	9	7
10	10	10	10	10	10	5	10	5	10	10	7	8	10	10	10	10	10	10	10	7
11	11	11	11	11	11	5	11	6	10	11	7	8	11	11	11	11	11	11	11	8
12	12	12	12	11	12	5	12	7	10	12	7	8	12	12	12	12	12	12	12	9
13	13	13	13	11	13	6	13	8	10	13	7	8	13	13	13	13	13	13	13	10
14	14	14	14	11	14	7	14	9	10	14	7	9	14	14	14	14	14	14	14	11
15	15	15	15	12	15	8	15	10	11	15	7	10	15	15	15	15	15	15	15	12
16	16	16	16	13	15	9	16	11	12	16	7	11	16	16	16	16	16	16	16	13
17	17	17	17	14	15	10	17	12	13	17	7	12	17	17	17	17	17	17	17	14
18	18	18	18	14	15	11	18	13	14	18	7	13	18	18	17	18	18	18	18	15
19	19	19	19	15	16	12	19	14	14	19	7	14	19	19	17	19	19	19	19	16
20	20	20	20	16	17	13	20	15	15	20	7	15	20	20	17	20	20	20	20	17
21	21	21	21	17	18	14	21	16	16	21	7	16	20	21	17	21	21	21	21	18
22	22	22	22	18	19	15	22	17	17	22	7	17	20	22	17	22	22	22	22	19
23	23	23	23	19	20	16	23	18	18	23	7	18	20	23	17	23	23	22	23	20
24	24	24	24	20	21	17	24	19	19	24	7	19	20	24	17	24	24	22	24	21
25	25	25	25	21	22	18	25	20	20	24	7	20	20	25	17	25	25	22	25	22
26	26	26	26	22	23	19	26	21	21	24	7	21	20	26	17	26	26	22	26	23
27	27	27	27	23	24	20	27	21	22	24	7	22	20	27	17	27	27	23	27	24
28	28	28	28	24	25	21	28	21	23	25	7	23	20	28	17	28	28	24	28	25
29	29	29	29	25	26	22	29	21	24	25	7	24	20	29	17	29	29	25	29	26
30	30	30	30	26	27	23	30	22	25	26	7	25	20	30	17	30	30	26	30	27
32	31	31	31	27	28	24	31	22	26	27	7	26	20	30	17	30	31	27	31	28
33	32	32	32	28	29	25	32	23	27	28	7	27	20	30	17	30	32	28	32	29
34	33	33	33	29	30	26	33	24	28	29	7	28	20	30	17	30	33	29	33	30
35	34	34	34	30	31	27	34	25	29	30	7	29	20	30	17	30	34	30	34	31
36	35	35	35	31	32	28	35	26	30	31	7	30	20	30	17	30	35	31	35	32
37	36	36	36	32	33	29	36	27	31	32	7	31	20	30	17	30	36	32	36	33
38	37	37	37	33	34	30	37	28	32	33	7	32	20	30	17	30	37	33	37	34
39	38	38	38	34	35	31	38	29	33	34	7	33	20	30	17	30	38	34	38	35
40	39	39	39	35	36	32	39	30	34	35	7	34	20	30	17	30	39	35	39	36
41	40	40	40	36	37	33	40	31	35	36	7	35	20	30	17	30	40	36	40	37
42	41	41	41	37	38	34	41	32	36	37	7	36	20	30	17	30	41	37	41	38
43	42	42	42	38	39	35	42	32	37	38	7	37	20	30	17	30	42	38	42	39
44	43	43	43	39	40	36	43	32	38	39	7	38	20	30	17	30	43	39	43	40
45	44	44	44	40	41	37	44	32	39	39	7	39	20	30	17	30	44	40	44	41
46	45	45	45	41	42	38	45	33	40	39	7	40	20	30	17	30	45	41	45	42
47	46	46	46	42	43	39	46	33	41	39	7	41	20	30	17	30	46	42	46	43
48	47	47	47	43	44	40	47	34	42	39	7	42	20	30	17	30	47	43	47	44
49	48	48	48	44	45	41	48	35	43	40	7	43	20	30	17	30	48	44	48	45
50	49	49	49	45	46	42	49	36	44	41	7	44	20	30	17	30	49	45	49	46
51	50	50	50	46	47	43	50	37	45	42	7	45	20	30	17	30	50	46	50	47
52	51	51	51	47	48	43	51	38	45	43	7	46	20	30	17	30	51	47	51	48
53	52	52	52	48	49	44	52	39	45	44	7	47	20	30	17	30	52	48	52	49
54	53	53	53	49	50	45	53	40	45	45	7	48	20	30	17	30	53	49	53	50
55	54	54	54	50	51	45	54	41	46	46	7	49	20	30	17	30	54	50	54	51
56	55	55	55	51	52	46	55	42	47	47	7	50	20	30	17	30	54	51	55	52
57	56	56	56	52	53	47	56	43	48	48	7	51	20	30	17	30	54	52	56	53
58	57	57	57	53	54	47	57	44	49	49	7	52	20	30	17	30	54	53	57	54
59	58	58	58	54	55	48	58	45	50	50	7	53	20	30	17	30	54	54	58	55
60	59	59	59	55	56	48	59	46	51	51	7	54	20	30	17	30	54	55	59	56
61	60	60	60	56	57	48	60	47	52	52	7	55	20	30	17	30	54	56	60	57
62	61	61	61	57	58	48	61	48	53	53	7	56	20	30	17	30	54	57	61	58
63	62	62	62	58	59	49	62	49	54	54	7	57	20	30	17	30	54	58	62	59
64	63	63	63	59	60	50	63	50	55	55	7	58	20	30	17	30	54	59	63	60
65	64	64	64	60	61	51	64	51	56	56	7	59	20	30	17	30	54	60	64	61
66	65	65	65	61	62	52	65	52	57	57	7	60	20	30	17	30	54	61	65	62
67	66	66	66	62	63	53	66	53	58	58	7	61	20	30	17	30	54	62	66	63
68	67	67	67	63	64	54	67	54	59	59	7	62	20	30	17	30	54	63	67	64
69	68	68	68	64	65	55	68	55	60	60	7	63	20	30	17	30	54	64	68	65
70	69	69	69	65	66	56	69	56	61	61	7	64	20	30	17	30	54	65	69	66
71	69	70	70	66	67	57	70	57	62	62	7	65	20	30	17	30	54	66	70	67
72	69	71	71	67	68	58	71	58	63	63	7	66	20	30	17	30	54	67	71	68
73	69	72	72	68	69	59	72	59	64	64	7	67	20	30	17	30	54	68	72	69
74	70	73	73	69	70	60	73	60	65	65	7	68	20	30	17	30	54	69	73	70
75	71	74	74	70	71	61	74	61	66	66	7	69	20	30	17	30	54	70	74	71
76	72	75	75	71	72	62	75	62	67	67	7	70	20	30	17	30	54	71	75	72
77	73	76	76	71	73	63	76	63	68	68	7	71	20	30	17	30	54	72	76	73
78	74	77	77	71	74	64	77	64	69	69	7	72	20	30	17	30	54	73	77	74
79	75	78	78	71	75	65	78	65	70	70	7	73	20	30	17	30	54	74	78	75
80	76	79	79	72	76	66	79	66	71	71	7	74	20	30	17	30	54	75	79	76
81	77	80	80	73	77	67	80	67	72	72	7	75	20	30	17	30	54	76	80	77
82	78	81	81	74	78	68	81	68	73	73	7	76	20	30	17	30	54	77	81	78
83	79	82	82	75	79	69	82	69	74	74	7	77	20	30	17	30	54	78	82	79
84	80	83	83	76	80	70	83	70	75	75	7	78	20	30	17	30	54	79	83	80
85	81	84	84	77	81	71	84	71	76	76	7	79	20	30	17	30	54	80	84	81
86	82	85	85	78	82	72	85	72	77	77	7	80	20	30	17	30	54	81	85	82
87	83	86	86	79	83	73	86	73	78	78	7	81	20	30	17	30	54	82	86	83
88	84	87	87	80	84	74	87	74	79	79	7	82	20	30	17	30	54	83	87	84
89	85	88	88	81	85	75	88	75	80	80	7	83	20	30	17	30	54	84	88	85
90	86	89	89	82	86	76	89	76	81	81	7	84	20	30	17	30	54	85	89	86
91	87	90	90	83	87	77	90	77	82	82	7	85	20	30	17	30	54	86	90	87
92	88	91	91	84	88	78	91	78	83	83	7	86	20	30	17	30	54	87	91	88
93	89	92	92	85	89	79	92	79	84	84	7	87	20	30	17	30	54	88	92	89
94	89	93	93	86	90	80	93	80	85	85	7	88	20	30	17	30	54	89	93	90
95	90	94	94	87	91	81	94	81	86	85	7	89	20	30	17	30	54	90	94	91
96	91	95	95	87	92	82	95	82	87	85	7	90	20	30	17	30	54	91	95	92
97	92	96	96	88	93	83	95	83	88	85	7	91	20	30	17	30	54	92	96	93
98	93	97	97	89	94	84	95	84	89	86	7	92	20	30	17	30	54	93	97	93
99	94	98	98	89	95	85	95	85	90	87	7	93	20	30	17	30	54	94	98	93
100	95	99	99	89	96	86	95	86	91	88	7	94	20	30	17	30	54	95	99	94
101	96	100	100	90	96	87	95	87	92	89	7	95	20	30	17	30	54	96	100	95
102	97	101	101	91	96	88	95	88	93	90	7	96	20	30	17	30	54	97	101	96
103	98	102	102	92	96	89	95	89	94	91	7	97	20	30	17	30	54	98	102	97
104	99	103	103	93	96	90	95	90	95	92	7	98	20	30	17	30	54	99	103	98
105	100	104	104	94	96	91	95	91	96	93	7	99	20	30	17	30	54	99	104	99
106	101	105	105	95	96	92	95	92	97	94	7	100	20	30	17	30	54	99	105	100
107	102	106	106	96	96	93	95	93	98	95	7	101	20	30	17	30	54	99	106	101
108	103	107	107	97	96	94	95	94	99	96	7	102	20	30	17	30	54	99	106	102
109	104	108	108	98	96	94	95	95	100	97	7	103	20	30	17	30	54	99	106	103
110	105	109	109	99	96	94	95	96	101	98	7	104	20	30	17	30	54	99	106	104
111	106	110	110	100	96	94	95	97	102	99	7	105	20	30	17	30	54	99	106	105
112	107	111	111	101	96	94	95	98	103	100	7	106	20	30	17	30	54	99	106	106
113	108	112	112	102	96	94	95	99	104	101	7	106	20	30	17	30	54	99	106	107
114	109	113	113	103	96	94	95	100	105	102	7	106	20	30	17	30	54	99	106	108
115	110	114	114	104	96	94	95	101	106	103	7	106	20	30	17	30	54	99	106	109
116	111	115	115	105	96	94	95	102	107	104	7	106	20	30	17	30	54	99	106	110
117	112	116	116	106	96	94	95	103	108	105	7	106	20	30	17	30	54	99	106	111
118	113	117	117	107	96	94	95	104	109	105	7	106	20	30	17	30	54	99	106	112
119	113	118	118	108	96	94	95	104	110	105	7	106	20	30	17	30	54	99	106	112
120	113	119	119	109	96	94	95	104	111	105	7	106	20	30	17	30	54	99	106	112
121	113	120	120	110	96	94	95	104	112	105	7	106	20	30	17	30	54	99	106	112
122	113	121	121	111	96	94	95	104	113	106	7	106	20	30	17	30	54	99	106	112
123	113	122	121	112	96	94	95	104	114	107	7	106	20	30	17	30	54	99	106	112
124	113	122	121	113	96	94	95	104	114	108	7	106	20	30	17	30	54	99	106	112
125	113	122	121	114	96	94	95	104	114	109	7	106	20	30	17	30	54	99	106	112
126	113	122	121	115	96	94	95	104	114	110	7	106	20	30	17	30	54	99	106	112
127	113	122	121	116	96	94	95	104	114	111	7	106	20	30	17	30	54	99	106	112
128	113	122	121	117	96	94	95	104	114	112	7	106	20	30	17	30	54	99	106	112
129	113	122	121	118	96	94	95	104	114	113	7	106	20	30	17	30	54	99	106	112
130	113	122	121	119	96	94	95	104	114	114	7	106	20	30	17	30	54	99	106	112
131	113	122	121	120	96	94	95	104	114	115	7	106	20	30	17	30	54	99	106	112
132	113	122	121	121	96	94	95	104	114	116	7	106	20	30	17	30	54	99	106	112
133	113	122	121	122	96	94	95	104	114	117	7	106	20	30	17	30	54	99	106	112
134	113	122	121	123	96	94	95	104	114	118	7	106	20	30	17	30	54	99	106	112
135	113	122	121	124	96	94	95	104	114	119	7	106	20	30	17	30	54	99	106	112
136	113	122	121	125	96	94	95	104	114	119	7	106	20	30	17	30	54	99	106	112
