[[90, 90, 90, 90, 90, 90, 90, 90, 90, 90, 90, 90, 90, 90, 90, 90, 90, 90, 90, 90], 
[89, 90, 89, 90, 90, 87, 89, 88, 90, 90, 89, 90, 89, 91, 89, 89, 88, 90, 91, 90], 
[89, 91, 86, 86, 90, 88, 88, 89, 93, 88, 89, 91, 89, 90, 86, 88, 91, 87, 90, 91], 
[92, 89, 93, 84, 92, 89, 83, 88, 88, 91, 89, 91, 91, 91, 88, 87, 90, 88, 88, 87], 
[92, 91, 95, 88, 91, 91, 91, 94, 80, 93, 83, 90, 94, 88, 87, 92, 97, 89, 85, 93], 
[96, 89, 84, 93, 80, 100, 84, 94, 89, 87, 81, 85, 100, 94, 93, 98, 89, 94, 86, 96], 
[78, 85, 79, 98, 85, 90, 97, 86, 93, 94, 86, 85, 92, 90, 85, 85, 84, 86, 92, 93], 
[81, 81, 94, 80, 95, 89, 87, 90, 92, 80, 80, 97, 72, 96, 79, 77, 92, 94, 98, 98], 
[80, 86, 100, 82, 91, 85, 85, 90, 100, 84, 98, 83, 93, 78, 91, 96, 91, 82, 80, 84], 
[85, 100, 80, 89, 86, 94, 84, 89, 90, 83, 77, 96, 93, 83, 76, 100, 97, 87, 97, 84], 
[82, 79, 75, 93, 92, 88, 89, 72, 100, 84, 62, 88, 100, 100, 89, 65, 85, 96, 69, 100]]